LEVEL
NAME STAGE01
TITLE MISSION 1
NEXT STAGE02.MAP
TILES
0000000000000000000000000000000000000000
0000000000000000000000000000000000000000
0000000000000000000000000000000000000000
0000000000000000000000011000000101000000
0111111111100111111111111101011101111100
1111110011011100011111100111110000111110
0110000000110000001110000001000000100110
1100000000100000000000000000000000000011
1100000000000000000000000000000000000011
1100000000000000000000000001000000000011
1000000000000000000000000011111111000011
1100000000000000000000000111010011000001
1100000000000001111000001111000011000011
0100000000000011111100001111100011000111
1100100000001111101110001111110011000110
1100000000011110000111011011111011000111
1110000000111010000011100010011011000011
1110000000111000000001110000011111000011
0110000000011000000000111000001111111110
1100000000110000000000011000000110111100
1100001111110000000000011000000110000000
1100001100000000001111101100000111110000
0101101100000011011000111100000011111011
0110001100000011010000001110000001111111
1111000111100011110000000111000001001111
0011000011100111101004000111100000000111
0110000001111111000000000011110000000011
0111000000111110000111000000110000000011
1110000000100100000001110000110000000011
1100000000000000000000110001100000000011
1110000000000000000000100001110000000001
1111101000001000000001100000111000000011
1101111000111101111111110000011100010111
1101111111110111111110100000011111111110
0000111000000111111110000000001111100000
0000100000000000000100000000000000000000
OBJECTS
MINER STATIC 887.00 306.00 24.00 24.00 0.00 0.00 0.00 1.00
ENEMY PATROL_X 254.00 490.00 32.00 32.00 154.00 354.00 70.00 1.00
ENEMY PATROL_X 253.00 352.00 32.00 32.00 153.00 353.00 70.00 1.00
POWERUP STATIC 1149.00 580.00 24.00 24.00 0.00 0.00 0.00 1.00
PLATFORM PATROL_X 112.00 724.00 100.00 20.00 12.00 212.00 40.00 1.00
PLATFORM PATROL_X 749.00 495.00 100.00 20.00 649.00 849.00 40.00 1.00
GOAL STATIC 1150.00 834.00 40.00 60.00 0.00 0.00 0.00 1.00
